11111111111111111111111111111111111111111111111111111111111
11111110001110000000000000000000000000000000000011111111001
1111110000010011111111111111111111111111111111101110C101111
11110001110000000000010000111111111C11111111111000000001111
10000011100111001111000110000000000000000000000011111111111
110001111C1111100101111111111111111111111111111111111111111
100011111111110011010000000C1111111111111111111111111111111
1000C111111100000000011111111111111111111111111111111111111
11111111111111111110111111111111111111111111111111111111111
1P00000A00000000000A0000000000000000000000000000000000000E1
11111110111111111111110011110111111111111111111111111111111
1111111011111100000000011111011C000011011111111111111111111
11111100001111011111111111110001111000001111111111111111111
1111100110111100000000C111111100000011111111111111111111111
11110111101111111111111111111111111111111111111111111111111
1110000000000000000000000000000000000000000000000C000011111
111111111111111111111111111111111111111111111111111110000C1
11111111111111111111111111111111111111111111111111111111111