11111111111111111111
1P0000000000000000C1
10000111111111100001
10000111111111100001
10111111111111111101
10111111111111111101
10111111111111111101
10000111111111100001
10000111111111100001
1C0000000000000000E1
11111111111111111111
