11111111111111111111
10000000000000000111
10111111111111110111
10111111111111110111
1011000000000E110111
10110111111111110111
10110111111111110111
1011000000000000C111
10111111111111111111
1P111111111111111111
11111111111111111111
