111111111111111111111111111111111111111111111111111
10010000000C000000000000000000000000000000000000001
100001111100000000000000000000000000000000000000001
1P0011E10000000000000000000000000000000000000000001
111111111111111111111111111111111111111111111111111