11111111111111111111
1P0000011111100000E1
10000111111111100001
10001111111111110001
10111111111111111101
10111111110111111101
10111111111111111101
10001111111111110001
10000111111111100001
1C0000000000000000C1
11111111111111111111
